###################
#                 #
# ############### #
# #             # #
# # ########### # #
# # #         # # #
# # # ####### # # #
# # # #     # # # #
# # # # ### # # # #
# # # # # # # # # #
# # # # # # # # # #
# # # # # # # # # #
# # # # # # # # # #
# # # # ### # # # #
# # # #     # # # #
# # # ####### # # #
# # #         # # #
# # ########### # #
# #             # #
# ############### #
#                 #
###################
