###################
#        #        #
#*## ### # ### ##*#
# ## ### # ### ## #
#                 #
# ## # ##### # ## #
#    #   #   #    #
#### ###-#-### ####
---# #-------# #---
#### #-##-##-# ####
---- --#---#-- ----
#### #-#####-# ####
---# #-------# #---
#### #-#####-# ####
#        #        #
# ## ### # ### ## #
#* #     -     # *#
## # # ##### # # ##
#    #   #   #    #
# ###### # ###### #
#                 #
###################
